13 1 7 0
15 1 4 0
14 1 6 5
22 1 4 0
31 1 5 1

16 2 2 7
18 2 3 0
13 2 5 0
3  2 4 6
78 2 2 0

19 3 1 8
13 3 3 0
23 3 2 0
9  3 1 3
28 3 2 0

19 4 4 4
13 4 5 0
23 4 3 0
9  4 4 2
28 4 6 0